#                      # 
#                      # 
#                      # 
#                      #   
#                      #
#                      #
#               0000000#
#                      #
#                      # 
#                      #
#                      #
#                      #
########################
